R 1280 720
NO ./resources/textures/50.xpm
SO ./resources/textures/50.xpm
WE ./resources/textures/50.xpm
EA ./resources/textures/50.xpm
S ./resources/textures/80.xpm
F 144,124,101
C 255,244,249

        1111111111111111111111111
        1000000000110000000000001
        1011000001110000002100001
        1001000000000000000000001
111111111011000001110000000000001
100000000011000001110111111111111
11110111111111011100000000001
11110111111111011101010010001
11000000110101011100000010001
10002000000000001100000010001
10000000000000001101010010001
11200001110101011111011110N0111
11110111 1110101 101111010001
11111111 1111111 111111111111
